11111111
1P000001
10011101
10100C01
10101E01
11111111
