111111111
1P0000001
100111101
10C000001
101111101
10000E001
111111111
