1111111111111111111111
1E000000000001C0010001
1011100100000111010101
101C000C00000000010101
1P00000100111000010C01
10111000001C1000010101
10000001000000000C0101
10000001C0000000010101
1111111111111111111111
