1111111
1P000E1
1011101
100C101
1111111
