11111111
1P000001
10011101
10100C01
10101001
11111111
