11111111
1P000001
10011101
10100001
10101E01
11111111
