11111111
10000001
10011101
10100C01
1E101E01
11111111
