1111111111111
10L10000000C1
1000011111001
1P0011E100001
1111111111111
